                                                    .                                                                   
                                                    .                                                                   
                                                    .                                                                   
                                                    .                                                                   
                                                    .                                                                   
                                                    .                                                                   
                                                    .                                                                   
                                                    .                                                                   
                                                    .                                                                   
                                                    .                                                                   
                                                    .                                                                   
                                                    .                                                                   
                                                    .                                                                   
                                                    .                                                                   
                                                    .                                                                   
               BBBBBBBBBBBBBBBBBBBBBBBBBBBB         .                                                                   
               BBBBBBBBBBBBBBBBBBBBBBBBBBBB         .                                                                   
               BBBBBBBBBBBBBBBBBBBBBBBBBBBB         .                                                                   
               BBB.....................BBBB         .                                                                   
               BBB.....................BBBB         .                                                                   
               BBB.....................BBBB         .                                                                   
               BBB.....................BBBB         .                                                                   
               BBB.....................BBBB         .                                                                   
               BBB.....................BBBB         .                                                                   
               BBB.....................BBBB         .                                                                   
               BBB.....................BBBB         .                                                                   
               BBB.....................BBBB         .                                                                   
               BBB.....................BBBB         .                                                                   
               BBB.....................BBBB         .                                                                   
               BBB.....................BBBB         .                                                                   
               BBB.....................BBBB         .                                                                   
               BBB.....................BBBB         .                                                                   
               BBB.....................BBBB         .                                                                   
               BBB.....................BBBB         .                                                                   
               BBB.....................BBBB         .                                                                   
               BBB.....................BBBB         .                          BBBBBBBBBBBBBBBBBBBBBBBBB                
               BBBBBBBBBBBBBBBBBBBBBBBBBBBB         .                          BBBBBBBBBBBBBBBBBBBBBBBBB                
               BBBBBBBBBBBBBBBBBBBBBBBBBBBB         .                          BBBBBBBBBBBBBBBBBBBBBBBBB                
               BBBBBBBBBBBBBBBBBBBBBBBBBBBB         .                          BBB..................BBBB                
               BBBBBBBBBBBBBBBBBBBBBBBBBBBB         .                          BBB..................BBBB                
                                        BBBBBBBBBBBB.BBBBBBB                   BBB..................BBBB                
                                        BBBBBBBBBBBB.BBBBBBB                   BBB..................BBBB                
                                        BBBBBBBBBBBB.BBBBBBB                   BBB..................BBBB                
                                        BBB.............BBBB                   BBB..................BBBB                
                                        BBB.............BBBB                   BBB..................BBBB                
                                        BBB.............BBBB                   BBB..................BBBB                
                                        BBB.............BBBB                   BBB..................BBBB                
                                        BBB.............BBBB                   BBB..................BBBB                
                                        BBB.............BBBB                   BBB..................BBBB                
                                        BBB.............BBBB                   BBB..................BBBB                
                                        BBB.............BBBB                   BBB..................BBBB                
                                        BBB.............BBBB                   BBB..................BBBB                
........................................................................................................................
                                        BBBBBBBBBBBB.BBBBBBB                   BBB..................BBBB                
                                    BBBBBBBBBBBBBBBB.BBBBBBB                   BBB..................BBBB                
                                    BBBBBBBBBBBBBBBB.BBBBBBB                   BBB..................BBBB                
                                    BBBBBBBBBBBBBBBB.BBBBBBB                   BBB..................BBBB                
                                    BBB..............BBBBBBBBBBBBBBBBBBBBBBBBBBBBB..................BBBB                
                                    BBB..............BBBBBBBBBBBBBBBBBBBBBBBBBBBBB..................BBBB                
                                    BBB..............BBBBBBBBBBBBBBBBBBBBBBBBBBBBBBBBBBBBBBBBBBBBBBBBBBB                
                                    BBB..............BBBBBBB..................BBBBBBBBBBBBBBBBBBBBBBBBBBBBBB            
                                    BBB..............BBBBBBB..................BBBBBBBBBBBBBBBBBBBBBBBBBBBBBB            
                                    BBB..............BBBBBBB..................BBBBBBBBBBBBBBBBBBBBBBBBBBBBBB            
                                    BBB..............BBBBBBB..................BBBB......................BBBB            
                                    BBB..............BBBBBBB..................BBBB......................BBBB            
                                    BBB..............BBBBBBB..................BBBB......................BBBB            
                                    BBB..............BBBBBBB..................BBBB......................BBBB            
                                    BBB..............BBBBBBB..................BBBB......................BBBB            
                                    BBB..............BBBBBBB..................BBBB......................BBBB            
                                    BBB..............BBBBBBB..................BBBB......................BBBB            
                                    BBB..............BBBBBBB..................BBBB......................BBBB            
                                    BBBBBBBBBBBBBBBB.BBBBBBB..................BBBB......................BBBB            
                                    BBBBBBBBBBBBBBBB.BBBBBBB..................BBBB......................BBBB            
                                    BBBBBBBBBBBBBBBB.BBBBBBB..................BBBBBBBBBBBBBBBBBBBBBBBBBBBBBB            
                                    BBBBBBBBBBBBBBBB.BBBBBBB..................BBBBBBBBBBBBBBBBBBBBBBBBBBBBBB            
                                                    .    BBB..................BBBBBBBBBBBBBBBBBBBBBBBBBBBBBB            
                                                    .    BBB..................BBBBBBBBBBBBBBBBBBBBBBBBBBBBBB            
                                                    .    BBBBBBBBBBBBBBBBBBBBBBBBBBB.................BBBB               
                                    BBBBBBBBBBBBBBBB.BBBBBBBBBBBBBBBBBBBBBBBBBBBBBBB.................BBBB               
                                    BBBBBBBBBBBBBBBB.BBBBBBBBBBBBBBBBBBBBBBBBBBBBBBB.................BBBB               
                                    BBBBBBBBBBBBBBBB.BBBBBBBBBBBBBBBBBBBBBBBBBBBBBBB.................BBBB               
                                    BBB......................BBBB...............BBBB.................BBBB               
                                    BBB......................BBBB...............BBBB.................BBBB               
                                    BBB......................BBBB...............BBBB.................BBBB               
                                    BBB......................BBBB...............BBBB.................BBBB               
                                    BBB......................BBBB...............BBBB.................BBBB               
                                    BBB......................BBBB...............BBBB.................BBBB               
                                    BBB......................BBBB...............BBBB.................BBBB               
                                    BBB......................BBBB...............BBBB.................BBBB               
                                    BBB......................BBBB...............BBBBBBBBBBBBBBBBBBBBBBBBB               
                                    BBB......................BBBB...............BBBBBBBBBBBBBBBBBBBBBBBBBB              
                                    BBB......................BBBB...............BBBBBBBBBBBBBBBBBBBBBBBBBB              
                                    BBB......................BBBB...............BBBBBBBBBBBBBBBBBBBBBBBBBB              
                                    BBB......................BBBB...............BBBB..................BBBB              
                                    BBB......................BBBB...............BBBB..................BBBB              
                                    BBB......................BBBB...............BBBB..................BBBB              
                                    BBB......................BBBB...............BBBB..................BBBB              
                                    BBBBBBBBBBBBBBBB.BBBBBBBBBBBB...............BBBB..................BBBB              
                                    BBBBBBBBBBBBBBBB.BBBBBBBBBBBB...............BBBB..................BBBB              
                                    BBBBBBBBBBBBBBBB.BBBBBBBBBBBB...............BBBB..................BBBB              
                                    BBBBBBBBBBBBBBBB.BBBBBBBBBBBB...............BBBB..................BBBB              
                                                    .         BBB...............BBBB..................BBBB              
                                                    .         BBB...............BBBB..................BBBB              
                                                    .         BBBBBBBBBBBBBBBBBBBBBB..................BBBB              
                                                    .         BBBBBBBBBBBBBBBBBBBBBB..................BBBB              
                                                    .         BBBBBBBBBBBBBBBBBBBBBB..................BBBB              
                                                    .         BBBBBBBBBBBBBBBBBBBBBB..................BBBB              
                                                    .                            BBB..................BBBB              
                                                    .                            BBB..................BBBB              
                                                    .                            BBBBBBBBBBBBBBBBBBBBBBBBB              
                                                    .                            BBBBBBBBBBBBBBBBBBBBBBBBB              
                                                    .                            BBBBBBBBBBBBBBBBBBBBBBBBB              
                                                    .                            BBBBBBBBBBBBBBBBBBBBBBBBB              
                                                    .                                                                   
                                                    .                                                                   
                                                    .                                                                   
                                                    .                                                                   
                                                    .                                                                   
                                                    .                                                                   
                                                    .                                                                   
