{==========================================================}
;.}{...}{..................................................:
;:.|;.:.|;.................................................:
;:.|;.:.|;.................................................:
=) (=.:.|;.................................................:
}[____].|;.................................................:
:{-}{-}.|;.................................................:
:|:||;:.|;.................................................:
:|:||;:.|;.................................................:
:|:||;:.|;.................................................:
:|:||;:.|;.................................................:
:|:||;:.|;.................................................:
:|:||;) (=.................................................:
:|:||;| |{.................................................:
:|:||;| |;.................................................:
:|:||;| |;.................................................:
:|:||;| |;.................................................:
:|:||;| |;.................................................:
:|:||;| |;.................................................:
:|:||;| |;.................................................:
:|:||;| |;.................................................:
:|:||;| |;.................................................:
:|:||;| |;.................................................:
:|:||;| |;.................................................:
:|:||;| |;.................................................:
:|:||;| |;.................................................:
:|:||;| |;.................................................:
:|:||;| |;.................................................:
:|:||;| |;.................................................:
:|:||;| |;.................................................:
:|:||;| |;.................................................:
:|:||;| |;.................................................:
:|:||;| |;.................................................:
:|:||;| |;.................................................:
:|:||;| |;.................................................:
:=) (=| |;.................................................:
:}| |{| |;.................................................:
::| |;| |;.................................................:
::| |;| |;.................................................:
::| |;| |;.................................................:
::| |;| |;.................................................:
::| |;| |;.................................................:
::| |;| |;.................................................:
::| |;| |;.................................................:
::| |;| |;.................................................:
::| |;| |;.................................................:
::| |;| |;.................................................:
::| |;| |;.................................................:
::| |;| |;.................................................:
::| |;| |;.................................................:
::| |;| |;.................................................:
::| |;| |;.................................................:
::| |;| |;.................................................:
::| |;| |;.................................................:
::| |;| |;.................................................:
::| |;| |;.................................................:
::| |;| |;.................................................:
::| |;| |;.................................................:
;.]][..][..................................................:
[__________________________________________________________]
