                      .......                               
                      .......                               
                      .......                               
                      .......                               
                      .......                               
                      .......                               
                      .......                               
       BBBBBBBBBBBBBBB.......BBB                            
       BBBBBBBBBBBBBBB.......BBB                            
       BBBBBBBBBBBBBBB.......BBB                            
       BBB...................BBB                            
       BBB...................BBB                            
       BBB...................BBB                            
       BBB...................BBB                            
       BBB...................BBB                            
       BBB...................BBB                            
       BBB...................BBB                            
       BBB...................BBB                            
       BBB...................BBB                            
       BBB...................BBB                            
       BBB...................BBB                            
............................................................
............................................................
............................................................
............................................................
............................................................
............................................................
............................................................
............................................................
............................................................
         BBB.................B............BBBB              
         BBB.................B............BBBB              
         BBB.................B............BBBB              
         BBB.................B............BBBB              
         BBB.................B............BBBB              
         BBB.................B............BBBB              
         BBB.................B............BBBB              
         BBB.................B............BBBB              
         BBB.................B............BBBB              
         BBB.................B............BBBB              
         BBBBBBBBBBBBB.......B............BBBB              
         BBBBBBBBBBBBB.......B............BBBB              
         BBBBBBBBBBBBB.......B............BBBB              
         BBBBBBBBBBBBB.......B............BBBB              
                      .......B............BBBB              
                      .......B............BBBB              
                      .......B............BBBB              
                      .......B............BBBB              
                      .......B............BBBB              
                      .......B............BBBB              
                      .......B............BBBB              
                      .......BBBBBBBBBBBBBBBBB              
                      .......BBBBBBBBBBBBBBBBB              
                      .......BBBBBBBBBBBBBBBBB              
                      .......BBBBBBBBBBBBBBBBB              
                      .......                               
                      .......                               
                      .......                               
                      .......                               
                      .......                               
